70 60
14 14 14 14 14 14 14 14 14 14 14 14 14 14 14 14 14 14 14 14 14 14 14 14 14 14 14 14 14 14 14 14 14 14 14 14 14 14 14 14 14 14 14 14 14 14 14 14 14 14 14 14 14 14 14 14 14 14 14 14 14 14 14 14 14 14 14 14 14 14
12 12 12 12 12 12 12 12 12 12 12 12 12 12 12 12 12 12 12 12 12 12 12 12 12 12 12 12 12 12 12 12 12 12 12 12 12 12 12 12 12 12 12 12 12 12 12 12 12 12 12 12 12 12 12 12 12 12 12 12 12 12 12 12 12 12 12 12 12 12
36 36 36 36 36 36 36 36 36 36 36 36 36 36 36 36 36 36 36 36 36 36 36 36 36 36 36 36 36 36 36 36 36 36 36 36 36 36 36 36 36 36 36 36 36 36 36 36 36 36 36 36 36 36 36 36 36 36 36 36 36 36 36 36 36 36 36 36 36 36
34 34 34 34 34 34 34 34 34 34 34 34 34 34 34 34 34 34 34 34 34 34 34 34 34 34 34 34 34 34 34 34 34 34 34 34 34 34 34 34 34 34 34 34 34 34 34 34 34 34 34 34 34 34 34 34 34 34 34 34 34 34 34 34 34 34 34 34 34 34
34 34 34 34 34 34 34 34 34 34 34 34 34 34 34 34 34 34 34 34 34 34 34 34 34 34 34 34 34 34 34 34 34 34 34 34 34 34 34 34 34 34 34 34 34 34 34 34 34 34 34 34 34 34 34 34 34 34 34 34 34 34 34 34 34 34 34 34 34 34
34 34 34 34 34 34 34 34 34 34 34 34 34 34 34 34 34 34 34 34 34 34 34 34 34 34 34 34 34 34 34 34 34 34 34 34 34 34 34 34 34 34 34 34 34 34 34 34 34 34 34 34 34 34 34 34 34 34 34 34 34 34 34 34 34 34 34 34 34 34
34 34 34 34 34 34 34 34 34 34 34 34 34 34 34 34 34 34 34 34 34 34 34 34 34 34 34 34 34 34 34 34 34 34 34 34 34 34 34 34 34 34 34 34 34 34 34 34 34 34 34 34 34 34 34 34 34 34 34 34 34 34 34 34 34 34 34 34 34 34
35 35 35 35 35 35 35 35 35 35 35 35 35 35 35 35 35 35 35 35 35 35 35 35 35 35 35 35 35 35 35 35 35 35 35 35 35 35 35 35 35 35 35 35 35 35 35 35 35 35 35 35 35 35 35 35 35 35 35 35 35 35 35 35 35 35 35 35 35 35
12 12 12 12 12 12 12 12 12 12 12 12 12 12 12 12 12 12 12 12 12 12 12 12 12 12 12 12 12 12 12 12 12 12 12 12 12 12 12 12 12 12 12 12 12 12 12 12 12 12 12 12 12 12 12 12 12 12 12 12 12 12 12 12 12 12 12 12 12 12
13 13 13 13 13 13 13 13 13 13 13 13 13 13 13 13 13 13 13 13 13 13 13 13 13 13 13 13 13 13 13 13 13 13 13 13 13 13 13 13 13 13 13 13 13 13 13 13 13 13 13 13 13 13 13 13 13 13 13 13 13 13 13 13 13 13 13 13 13 13
0 0 0 0 0 0 0 0 0 0 0 0 0 0 0 1 0 0 0 0 0 0 0 0 0 0 0 0 0 0 0 0 0 0 0 0 0 0 0 0 0 0 0 0 0 0 0 0 0 0 0 0 0 0 0 0 0 0 0 0 0 0 0 0 0 0 0 0 0 0
0 0 0 0 0 0 0 0 0 0 0 0 0 0 0 4 0 1 2 0 0 0 0 0 0 0 0 0 0 0 0 0 0 0 0 0 0 0 0 0 0 0 0 0 0 0 0 0 0 0 0 0 0 0 0 0 0 0 0 0 0 0 0 0 0 0 0 0 0 0
0 0 0 0 0 0 0 0 0 0 0 0 0 0 0 0 0 11 3 0 0 0 0 0 0 0 0 0 0 0 0 0 0 0 0 0 0 0 0 0 0 0 0 0 0 0 0 0 0 0 0 0 0 0 0 0 0 0 0 0 0 0 0 0 0 0 0 0 0 0
0 0 0 0 0 0 0 0 0 0 0 0 2 0 0 0 1 11 0 4 2 0 0 0 0 0 0 0 0 0 0 0 0 0 0 0 0 0 0 0 0 0 0 0 0 0 0 0 0 0 0 0 0 0 0 0 0 0 0 0 0 0 0 0 0 0 0 0 0 0
0 0 0 0 0 0 0 0 0 0 0 3 0 0 0 0 4 11 2 0 0 0 0 0 0 0 0 0 0 0 0 0 0 0 0 0 0 0 0 0 0 0 0 0 0 0 0 0 0 0 0 0 0 0 0 0 0 0 0 0 0 0 0 0 0 0 0 0 0 0
0 0 0 0 0 0 0 0 0 0 0 0 0 0 0 0 1 11 11 0 0 0 0 0 0 0 0 0 0 0 0 0 0 0 0 0 0 0 0 0 0 0 0 0 0 0 0 0 0 0 0 0 0 0 0 0 0 0 0 0 0 0 0 0 0 0 0 0 0 0
0 0 0 0 0 0 0 0 0 0 0 7 0 4 0 0 11 11 11 21 0 0 0 0 0 0 0 0 0 0 0 0 0 0 1 11 11 11 11 11 11 11 11 11 11 2 0 0 0 0 0 0 0 0 0 0 0 0 0 0 0 0 0 0 0 0 0 0 0 0
0 0 0 5 0 0 0 0 5 0 0 6 0 0 0 21 11 11 11 2 0 0 0 0 0 0 0 0 1 11 11 11 11 11 11 11 11 11 11 11 11 11 11 11 11 11 2 0 0 0 0 0 0 0 0 0 0 0 0 0 0 0 0 0 0 0 0 0 0 0
0 0 0 0 0 0 0 0 0 0 0 0 0 0 0 0 4 11 11 11 11 11 11 11 11 11 11 11 11 11 11 11 11 11 11 11 11 11 11 11 11 11 11 11 11 11 11 2 0 0 0 0 0 0 0 0 0 0 0 0 0 0 0 0 0 0 0 0 0 0
0 0 0 0 0 0 0 0 0 0 0 0 0 0 0 0 0 11 11 11 11 11 11 11 11 11 11 11 11 11 11 11 11 11 3 0 0 0 0 0 0 0 0 0 4 11 11 11 2 0 0 0 0 0 0 0 0 0 0 0 0 0 0 0 0 0 0 0 0 0
0 0 0 0 0 0 0 1 11 11 11 11 2 0 0 0 1 11 11 11 11 11 11 11 11 11 11 11 3 0 0 0 0 0 0 0 0 0 0 0 0 0 0 0 0 4 11 11 11 2 0 0 0 0 0 0 0 0 0 0 0 0 0 0 0 0 0 0 0 0
7 0 0 0 1 11 11 11 11 11 11 11 11 11 11 11 11 11 11 3 0 0 0 0 0 0 0 0 0 0 0 0 0 0 0 0 0 0 0 0 0 0 0 0 0 0 4 11 11 11 2 0 0 0 0 0 0 0 0 0 0 0 0 0 0 0 0 0 0 0
6 0 0 1 11 11 11 11 11 11 11 11 11 11 11 11 11 11 3 0 0 0 0 0 0 0 0 0 0 0 0 0 0 0 0 0 0 0 0 0 0 0 0 0 0 0 0 4 11 11 11 2 0 0 0 0 0 0 0 0 0 0 0 0 0 0 0 0 0 0
0 0 0 11 11 11 11 11 11 11 11 11 11 11 11 11 11 11 0 0 0 0 0 0 0 0 0 0 0 0 0 0 0 0 0 0 0 0 0 0 0 0 0 0 0 0 0 0 4 11 11 11 0 0 0 0 0 0 0 0 0 0 0 0 0 0 0 0 0 0
0 0 1 11 11 11 11 11 11 11 11 11 11 11 11 11 11 11 2 0 0 0 0 0 0 0 0 0 0 0 0 0 0 0 0 0 0 0 0 0 0 0 0 0 0 0 0 0 0 11 11 11 0 0 0 0 0 0 0 0 0 0 0 0 0 0 0 0 0 0
0 0 11 11 11 11 11 11 11 11 11 11 11 11 11 11 11 11 11 0 0 0 5 0 0 0 0 0 0 0 0 0 0 0 0 0 0 0 0 0 0 0 0 0 0 0 0 0 0 11 11 11 0 0 0 0 0 0 0 0 0 0 0 0 0 0 0 0 0 0
0 0 11 11 11 11 11 11 11 11 11 11 11 11 11 11 11 11 11 0 0 0 0 0 0 0 0 0 0 0 0 0 0 0 0 0 0 0 0 0 0 0 0 0 0 0 0 0 0 11 11 11 0 0 0 0 0 0 0 0 0 0 0 0 0 0 0 0 0 0
0 0 11 11 11 11 11 11 11 11 11 11 11 11 11 11 11 11 11 0 0 0 7 0 0 0 0 0 0 0 0 0 0 0 0 0 0 0 0 0 0 0 0 0 0 0 0 0 0 11 11 11 0 0 0 0 0 0 0 0 0 0 0 0 0 0 0 0 0 0
0 0 4 11 11 11 11 11 11 11 11 11 11 11 11 11 11 11 3 0 0 0 6 7 0 0 0 0 0 0 0 0 0 0 0 0 0 0 0 0 0 0 0 0 0 0 0 0 0 11 11 11 0 0 0 0 0 0 0 0 0 0 0 0 0 0 0 0 0 0
0 0 0 4 11 11 11 11 11 11 11 11 11 11 11 11 11 3 0 0 0 0 0 6 0 0 0 0 0 0 0 0 0 0 0 0 0 0 0 0 0 0 0 0 0 0 0 0 0 11 11 11 0 0 0 0 0 0 0 0 0 0 0 0 0 0 0 0 0 0
0 0 0 0 0 4 11 11 11 11 11 11 11 11 11 3 0 0 0 0 0 0 0 0 0 0 0 0 0 0 0 0 0 0 0 0 0 0 0 0 0 0 0 0 0 0 0 0 1 11 11 11 0 0 0 0 0 0 0 0 0 0 0 0 0 0 0 0 0 0
0 0 0 0 7 0 0 0 0 4 11 11 11 3 0 0 0 0 0 0 0 0 0 0 0 0 0 0 0 0 0 0 0 0 0 0 0 0 0 0 0 0 0 0 0 0 0 1 11 11 11 3 0 0 0 0 0 0 0 0 0 0 0 0 0 0 0 0 0 0
0 5 0 0 6 0 0 0 0 0 0 0 0 0 0 0 0 0 0 0 0 0 5 0 0 0 0 0 0 0 0 0 0 0 0 0 0 0 0 0 0 0 0 0 0 21 1 11 11 11 3 0 0 0 0 0 0 0 0 0 0 0 0 0 0 0 0 0 0 0
0 0 0 0 0 0 0 0 0 0 0 0 0 0 0 0 0 0 0 0 0 0 0 0 0 0 0 0 0 0 0 0 0 0 0 0 0 0 0 0 0 0 0 0 0 1 11 11 11 3 0 0 0 0 0 0 0 0 0 0 0 0 0 0 0 0 0 0 0 0
0 0 0 0 0 0 0 0 0 0 0 0 0 0 0 0 0 0 0 0 0 0 0 0 0 0 0 0 0 0 0 0 0 0 0 0 0 0 1 11 11 11 11 11 11 11 11 11 3 21 0 0 0 0 0 0 0 0 0 0 0 0 0 0 0 0 0 0 0 0
0 0 0 0 0 0 0 0 0 0 15 19 19 19 19 19 19 19 19 16 0 0 0 0 0 0 0 0 0 0 0 0 0 0 0 0 0 1 11 11 11 11 11 11 11 11 11 11 0 0 0 0 0 0 0 0 0 0 0 0 0 0 0 0 0 0 0 0 0 0
0 0 0 0 0 15 19 19 19 19 17 0 0 0 0 0 0 0 0 18 19 19 19 19 19 16 0 0 0 0 0 0 0 0 0 0 1 11 11 11 11 11 11 11 11 11 11 11 2 0 0 0 0 0 0 0 0 0 0 0 0 0 0 0 0 0 0 0 0 0
0 0 0 15 19 17 0 0 0 0 0 0 0 0 0 0 7 0 0 0 0 0 0 0 0 18 19 16 0 0 0 0 0 0 0 1 11 11 11 3 0 0 0 0 0 4 11 11 11 2 0 0 0 0 0 0 0 0 0 0 0 0 0 0 0 0 0 0 0 0
0 0 15 17 0 0 0 0 0 0 10 0 0 0 0 0 6 0 7 0 0 0 0 0 0 0 0 20 0 0 0 0 0 0 1 11 11 11 3 0 0 0 0 0 0 0 4 11 11 11 2 0 0 0 0 0 0 0 0 0 0 0 0 0 0 0 0 0 0 0
0 0 20 0 0 31 0 0 0 0 0 0 0 0 0 0 0 0 6 0 0 0 0 1 11 11 11 11 11 11 11 11 30 11 11 11 11 3 0 0 0 0 0 8 0 0 0 4 11 11 11 11 2 30 0 0 0 0 0 0 0 0 0 0 0 0 0 0 0 0
0 0 20 0 32 33 32 0 0 0 0 0 0 0 0 0 0 0 0 0 0 0 1 11 11 11 11 11 11 11 11 30 30 30 11 11 3 0 0 0 0 0 0 0 0 0 0 1 11 11 11 11 11 30 11 11 2 0 0 0 0 0 0 0 0 0 0 0 0 0
0 15 17 0 30 31 30 0 0 0 7 0 0 0 0 0 1 11 11 11 11 11 11 11 11 11 11 11 11 11 11 30 30 30 11 3 0 0 7 0 0 0 0 0 0 0 1 11 11 11 11 11 30 30 30 11 11 11 11 2 0 0 0 0 0 29 0 0 0 0
0 20 0 33 32 33 32 33 0 0 6 0 0 0 0 1 11 11 11 11 11 11 11 11 3 0 0 20 0 0 30 30 30 30 30 0 0 0 6 0 5 0 0 0 0 0 11 11 11 11 11 11 30 30 30 11 11 11 11 11 11 2 0 0 26 27 28 0 0 0
0 20 0 31 30 31 30 31 0 0 0 0 0 0 1 11 11 11 11 11 11 11 11 3 0 0 0 20 0 0 30 30 30 30 30 0 0 0 0 0 0 0 0 0 0 1 11 11 11 11 3 30 30 30 30 30 11 11 11 11 11 11 0 0 0 0 0 0 0 0
0 20 0 33 32 33 32 33 0 0 0 0 0 1 11 11 11 3 0 0 0 0 0 0 0 0 0 20 0 0 30 30 30 30 30 0 0 0 32 0 0 0 0 0 0 11 11 11 11 3 0 30 30 30 30 30 7 4 11 11 11 11 0 0 0 0 0 0 0 0
0 20 0 0 30 31 30 0 0 0 0 0 1 11 11 11 3 0 0 0 0 0 0 0 0 0 0 20 0 0 0 30 30 30 0 0 0 32 32 32 0 0 0 0 1 11 11 11 3 7 5 30 30 30 30 30 6 0 4 11 11 11 2 0 5 0 0 0 0 0
0 20 0 0 22 23 24 0 0 0 0 1 11 11 11 3 0 0 0 31 0 0 0 0 0 0 0 20 0 0 0 22 23 24 0 0 31 32 32 32 31 0 0 0 11 11 11 11 0 6 0 30 30 30 30 30 0 5 0 11 11 11 11 0 0 0 0 0 0 0
0 20 0 8 0 0 0 0 0 0 1 11 11 11 3 0 0 0 32 33 32 0 0 8 0 0 15 17 0 0 9 0 0 0 0 0 31 32 32 32 31 0 0 0 11 11 11 11 0 10 8 0 30 30 30 0 0 7 0 11 11 11 11 0 0 7 0 0 9 0
0 20 0 0 0 0 0 0 0 1 11 11 11 3 0 0 0 0 30 31 30 0 0 0 0 0 20 0 0 0 0 0 0 0 5 0 31 32 32 32 31 0 0 0 11 11 11 11 5 0 0 0 26 27 28 0 7 6 0 11 11 11 11 0 0 6 0 0 0 0
0 20 0 0 0 0 0 0 0 11 11 11 3 0 0 0 0 31 32 33 32 33 0 0 7 0 20 0 0 0 0 0 0 0 0 0 0 32 32 32 10 0 0 0 11 11 11 11 0 0 7 0 0 0 0 0 6 0 0 11 11 11 11 0 0 0 7 0 0 0
0 18 16 0 0 0 0 0 0 11 11 11 0 0 0 0 0 31 30 31 30 31 0 7 6 0 20 0 0 0 0 0 0 0 0 0 0 8 29 0 0 0 0 0 11 11 11 11 2 0 6 0 7 0 5 0 0 0 1 11 11 11 3 0 0 0 6 0 0 0
0 0 20 0 0 0 0 0 0 11 11 11 0 0 0 0 0 30 32 33 32 33 0 6 0 15 17 0 0 0 0 0 0 0 0 0 0 26 29 28 0 0 0 0 4 11 11 11 11 0 0 0 6 0 0 0 1 11 11 11 11 11 0 0 0 0 0 0 0 0
0 0 20 0 0 0 0 0 1 11 11 11 0 0 9 0 0 0 30 31 30 0 0 0 0 20 0 0 0 0 0 7 0 0 0 0 0 0 0 0 0 0 0 0 0 11 11 11 11 2 5 0 0 0 1 11 11 11 11 11 11 3 0 0 0 0 0 0 0 5
0 0 20 0 0 0 0 1 11 11 11 3 0 0 0 0 0 0 26 27 28 0 0 0 0 20 0 0 0 0 0 6 0 0 0 0 0 0 0 0 0 0 0 0 0 4 11 11 11 11 11 11 11 11 11 11 11 11 11 11 11 0 0 0 0 0 0 0 0 0
0 0 20 0 0 0 1 11 11 11 3 0 0 0 0 0 7 0 0 0 0 0 0 0 0 20 0 0 0 0 0 0 0 0 0 0 0 0 0 0 0 0 0 0 0 0 11 11 11 11 11 11 11 11 11 11 11 11 11 11 3 0 0 0 0 0 0 0 0 0
0 0 20 0 0 1 11 11 11 3 0 0 0 0 0 0 6 0 0 0 0 0 0 15 19 17 0 0 0 0 0 0 0 0 0 0 0 0 0 0 0 0 0 0 0 0 4 11 11 11 11 11 11 11 11 11 11 3 0 0 0 0 0 0 25 0 8 0 0 0
0 0 0 0 1 11 11 11 3 0 0 0 0 0 0 0 0 0 0 15 19 19 19 17 0 0 0 0 0 0 0 0 0 0 0 0 0 0 7 0 0 0 0 5 0 0 0 0 0 4 11 11 11 11 3 0 0 0 0 0 0 0 0 22 23 24 0 0 0 0
0 0 0 1 11 11 11 3 0 0 0 0 15 19 19 19 19 19 19 17 0 0 0 0 0 0 0 0 0 0 5 0 0 0 0 0 0 7 6 0 0 0 0 0 0 0 0 0 0 0 0 0 0 0 0 0 0 0 0 0 0 0 0 0 0 0 0 0 0 0
0 0 1 11 11 11 3 0 15 19 19 19 17 0 0 0 0 0 0 0 0 0 0 0 0 0 0 0 0 0 0 0 0 0 0 0 0 6 0 0 0 0 0 0 0 0 0 0 0 0 0 0 0 0 0 0 0 0 5 0 0 0 0 0 0 0 0 0 0 0
0 1 11 11 11 3 0 0 0 0 0 0 0 0 0 0 0 0 0 0 0 0 0 0 0 0 0 0 0 0 0 0 0 0 0 0 0 0 0 0 0 0 0 0 0 0 0 0 0 10 8 0 0 0 0 0 0 5 0 0 0 0 0 0 0 0 0 0 0 0