70 60
14 14 14 14 14 14 14 14 14 29 29 29 14 14 14 14 14 14 14 14 14 14 14 14 14 14 14 14 14 14 14 14 14 14 14 14 14 14 14 14 14 14 14 14 14 14 14 14 14 14 14 14 14 14 14 14 14 14 14 14 14 14 14 14 14 14 14 14 14 14
12 12 12 12 12 12 12 12 12 29 29 29 12 12 12 12 12 12 12 12 12 12 12 12 12 12 12 12 12 12 12 12 12 12 12 12 12 12 12 12 12 12 12 12 12 12 12 12 12 12 12 12 12 12 12 12 12 12 12 12 12 12 12 12 12 12 12 12 12 12
46 46 46 46 46 46 46 46 46 29 29 29 46 46 46 46 46 46 46 46 46 46 46 46 46 46 46 46 46 46 46 46 46 46 46 46 46 46 46 46 46 46 46 46 46 46 46 46 46 46 46 46 46 46 46 46 46 46 46 46 46 46 46 46 46 46 46 46 46 46
44 44 44 44 44 44 44 44 44 29 29 29 44 44 44 44 44 44 44 44 44 44 44 44 44 44 44 44 44 44 44 44 44 44 44 44 44 44 44 44 44 44 44 44 44 44 44 44 44 44 44 44 44 44 44 44 44 44 44 44 44 44 44 44 44 44 44 44 44 44
44 44 44 44 44 44 44 44 44 29 29 29 44 44 44 44 44 44 44 44 44 44 44 44 44 44 44 44 44 44 44 44 44 44 44 44 44 44 44 44 44 44 44 44 44 44 44 44 44 44 44 44 44 44 44 44 44 44 44 44 44 44 44 44 44 44 44 44 44 44
44 44 44 44 44 44 44 44 44 29 29 29 44 44 44 44 44 44 44 44 44 44 44 44 44 44 44 44 44 44 44 44 44 44 44 44 44 44 44 44 44 44 44 44 44 44 44 44 44 44 44 44 44 44 44 44 44 44 44 44 44 44 44 44 44 44 44 44 44 44
44 44 44 44 44 44 44 44 44 47 47 47 44 44 44 44 44 44 44 44 44 44 44 44 44 44 44 44 44 44 44 44 44 44 44 44 44 44 44 44 44 44 44 44 44 44 44 44 44 44 44 44 44 44 44 44 44 44 44 44 44 44 44 44 44 44 44 44 44 44
45 45 45 45 45 45 45 45 45 29 29 29 45 45 45 45 45 45 45 45 45 45 45 45 45 45 45 45 45 45 45 45 45 45 45 45 45 45 45 45 45 45 45 45 45 45 45 45 45 45 45 45 45 45 45 45 45 45 45 45 45 45 45 45 45 45 45 45 45 45
12 12 12 12 12 12 12 12 12 29 29 29 12 12 12 12 12 12 12 12 12 12 12 12 12 12 12 12 12 12 12 12 12 12 12 12 12 12 12 12 12 12 12 12 12 12 12 12 12 12 12 12 12 12 12 12 12 12 12 12 12 12 12 12 12 12 12 12 12 12
13 13 13 13 13 13 13 13 13 29 29 29 13 13 13 13 13 13 13 13 13 13 13 13 13 13 13 13 13 13 13 13 13 13 13 13 13 13 13 13 13 13 13 13 13 13 13 13 13 13 13 13 13 13 13 13 13 13 13 13 13 13 13 13 13 13 13 13 13 13
0 0 0 0 0 0 0 0 0 29 29 29 0 8 0 0 1 11 2 0 0 0 0 0 37 30 30 30 36 0 0 0 0 0 0 0 0 0 0 0 0 0 0 0 0 0 0 0 0 0 0 0 0 0 0 0 0 0 0 0 0 0 0 0 0 0 0 0 0 0
0 0 0 0 0 0 0 0 26 27 27 27 28 0 0 0 11 11 11 0 0 0 0 0 30 30 30 30 30 0 0 0 5 0 0 0 0 0 0 0 0 0 0 0 0 0 0 37 30 30 30 36 0 0 7 0 7 0 0 0 5 0 0 0 0 0 0 0 0 0
0 0 0 0 0 0 0 0 10 0 0 0 0 0 0 0 11 11 11 0 0 0 0 0 30 30 30 30 30 0 0 0 0 0 0 0 0 0 7 0 0 0 0 0 0 0 0 30 30 30 30 30 0 0 6 0 6 0 0 0 0 37 30 30 30 36 0 0 0 0
0 8 0 0 0 0 0 0 0 0 0 0 0 0 0 0 11 11 11 0 0 0 5 0 30 30 30 30 30 0 0 0 0 0 0 7 0 0 6 0 5 0 0 0 0 0 0 30 30 30 30 30 0 0 0 0 0 0 0 0 0 30 30 30 30 30 0 0 5 0
0 0 0 37 30 30 30 36 0 0 0 0 0 0 0 0 11 11 11 0 0 0 0 0 35 30 30 30 34 0 0 0 0 0 0 6 0 0 0 0 0 0 0 0 0 0 0 30 30 30 30 30 0 0 0 0 0 0 0 0 0 30 30 30 30 30 0 0 0 0
0 0 0 30 30 30 30 30 0 0 0 0 0 0 0 0 11 11 11 0 0 0 0 0 0 22 23 24 0 0 0 0 0 0 0 0 0 0 0 0 0 0 0 0 0 0 0 35 30 30 30 34 0 0 0 0 0 0 10 8 0 30 30 30 30 30 0 0 0 0
0 5 0 30 30 30 30 30 0 0 0 7 0 0 0 0 11 11 11 21 0 0 0 8 0 0 0 0 0 0 0 0 0 0 1 11 11 11 11 11 11 11 11 11 11 2 0 0 26 27 28 0 0 0 0 0 0 0 0 0 0 35 30 30 30 34 0 0 0 0
0 0 0 30 30 30 30 30 5 0 0 6 0 0 0 21 11 11 11 2 0 0 0 0 0 0 0 0 1 11 11 11 11 11 11 11 11 11 11 11 11 11 11 11 11 11 2 0 0 0 0 0 0 0 0 0 0 0 0 0 0 0 22 27 24 0 0 0 0 0
0 7 0 35 30 30 30 34 0 0 0 0 0 0 0 0 4 11 11 11 11 11 11 11 11 11 11 11 11 11 11 11 11 11 11 11 11 11 11 11 11 11 11 11 11 11 11 2 0 0 0 0 5 0 37 30 30 30 36 0 0 0 0 0 0 0 0 0 0 0
0 6 7 0 22 23 24 0 0 0 0 0 0 0 8 0 0 11 11 11 11 11 11 11 11 11 11 11 41 30 30 30 40 11 3 0 0 0 0 0 0 0 5 0 4 11 11 11 2 0 0 0 0 0 30 30 30 30 30 0 0 5 0 0 0 0 0 0 0 0
0 0 6 0 0 0 0 1 11 11 11 11 2 0 0 0 1 11 11 11 11 11 11 11 11 11 11 11 30 30 30 30 30 0 0 0 0 0 0 0 0 0 0 0 0 4 11 11 11 2 0 0 0 0 30 30 30 30 30 0 0 0 0 0 0 0 0 0 0 0
7 0 0 0 1 11 11 11 11 11 11 11 11 11 11 11 11 11 11 3 0 0 0 0 0 0 0 0 30 30 30 30 30 0 0 0 0 9 10 0 0 0 0 0 0 0 4 11 11 11 2 0 0 0 30 30 30 30 30 0 0 0 0 0 0 0 0 0 0 0
6 0 0 1 11 11 11 11 11 11 11 11 11 11 11 11 11 11 3 0 0 0 0 0 0 0 0 0 30 30 30 30 30 0 0 5 0 0 0 0 0 0 7 0 0 0 0 4 11 11 11 2 0 0 35 30 30 30 34 0 0 0 0 0 0 0 0 0 5 0
0 0 0 11 11 11 11 11 11 11 11 11 11 11 11 11 11 11 0 0 0 0 0 0 0 0 0 0 35 30 30 30 34 0 0 0 0 0 0 0 0 0 6 0 7 7 0 0 4 11 11 11 0 0 0 0 29 0 9 0 0 37 30 30 30 36 0 0 5 5
0 0 1 11 11 11 11 11 11 11 11 11 11 11 11 11 11 11 2 0 0 0 0 0 0 0 0 0 0 0 25 0 0 0 0 0 0 0 0 0 0 0 0 0 6 6 0 0 0 11 11 11 0 0 0 26 27 28 0 0 0 30 30 30 30 30 0 5 0 0
0 0 11 11 11 11 11 11 11 11 11 11 11 11 11 11 11 11 11 0 0 0 5 0 0 0 8 0 0 22 23 24 0 0 0 0 0 0 0 0 0 0 0 0 0 5 0 0 0 11 11 11 0 0 0 0 0 0 7 0 0 30 30 30 30 30 0 0 0 5
0 0 11 11 11 11 11 11 11 11 11 11 11 11 11 11 11 11 11 0 0 0 0 0 0 0 0 0 0 0 0 0 0 7 0 0 0 37 30 30 30 36 0 0 0 0 0 0 0 11 11 11 0 0 0 0 0 0 6 0 0 30 30 30 30 30 0 0 0 0
0 0 11 11 11 11 11 11 11 11 11 11 11 11 11 11 11 11 41 30 30 30 36 0 0 0 0 5 0 0 0 0 0 6 7 0 0 30 30 30 30 30 0 0 0 0 0 0 0 11 11 11 0 0 0 0 0 0 0 0 0 35 30 30 30 34 0 0 0 0
0 0 4 11 11 11 11 11 11 11 11 11 11 11 11 11 11 11 30 30 30 30 30 7 0 0 0 0 0 0 0 0 0 0 6 0 0 30 30 30 30 30 0 0 0 0 0 0 0 11 11 11 0 8 10 0 0 0 0 0 0 0 22 23 24 0 0 0 0 0
37 30 30 30 40 11 11 11 11 11 11 11 11 11 11 11 11 3 30 30 30 30 30 6 0 0 0 0 0 0 0 0 0 0 0 0 0 30 30 30 30 30 0 0 0 0 0 0 0 11 11 11 0 0 0 0 0 0 0 0 0 0 0 0 0 0 0 0 0 0
30 30 30 30 30 4 11 11 11 11 11 11 11 11 11 3 0 0 30 30 30 30 30 0 0 0 0 0 0 37 30 30 30 36 0 0 0 35 30 30 30 34 0 0 0 0 0 0 1 11 11 11 0 0 0 0 0 0 0 0 0 0 5 0 0 0 0 0 0 0
30 30 30 30 30 0 0 7 0 4 11 11 11 3 0 0 0 0 35 30 30 30 34 0 0 0 0 0 0 30 30 30 30 30 5 0 0 0 0 29 0 0 0 5 0 0 0 1 11 11 11 3 0 0 0 37 30 30 30 36 0 0 0 0 0 0 0 0 0 0
32 30 30 30 31 10 0 6 0 0 0 0 0 0 0 0 0 0 0 26 27 28 5 0 0 0 0 0 0 30 30 30 30 30 0 0 0 0 26 27 28 0 0 0 0 21 1 11 11 11 3 0 0 0 0 30 30 30 30 30 0 0 0 0 7 0 0 0 0 0
35 32 30 32 34 7 0 0 0 5 0 0 0 0 0 0 0 0 0 0 0 0 0 0 0 0 0 0 0 30 30 30 30 30 0 0 0 0 0 0 0 0 0 0 0 1 11 11 11 3 0 0 0 0 0 30 30 30 30 30 0 0 7 0 6 0 0 0 0 0
8 0 25 0 0 6 0 0 0 0 0 0 0 0 0 0 5 0 0 0 0 8 0 0 0 0 0 0 0 35 30 30 30 34 0 0 0 0 1 11 11 11 11 11 11 11 11 11 3 21 0 0 0 0 0 30 30 30 30 30 0 0 6 0 0 0 0 0 0 0
0 22 23 24 0 0 0 0 0 0 15 19 19 19 19 19 19 19 19 16 0 0 0 0 0 0 0 0 5 0 22 23 24 0 0 0 0 1 11 11 11 11 11 11 11 11 11 11 0 0 0 5 0 0 0 35 30 30 30 34 0 0 0 0 0 0 0 0 0 0
0 0 0 0 0 15 19 19 19 19 17 0 0 0 0 0 0 0 0 18 19 19 19 19 19 16 0 0 0 0 0 0 0 0 0 0 1 11 11 41 30 30 30 40 11 11 11 11 2 0 0 0 0 0 0 0 0 25 0 0 0 0 0 37 30 30 30 36 0 0
0 0 0 15 19 17 0 0 0 0 0 0 0 0 0 0 7 0 0 0 0 0 0 0 0 18 19 16 0 0 0 0 0 10 0 1 11 11 11 30 30 30 30 30 0 4 11 11 11 2 0 0 0 0 0 0 22 23 24 0 0 0 0 30 30 30 30 30 0 0
0 0 15 17 0 0 0 0 0 0 10 0 0 0 0 0 6 0 7 0 0 0 0 0 0 0 0 20 0 0 0 0 0 0 1 11 11 11 3 30 30 30 30 30 0 0 4 11 11 11 2 0 0 0 0 0 0 0 0 0 5 0 0 30 30 30 30 30 0 0
0 0 20 0 0 0 0 0 0 0 0 0 0 0 0 0 0 0 6 0 0 5 0 1 11 11 11 11 11 11 11 11 11 11 11 11 11 3 0 30 30 30 30 30 0 0 0 4 11 11 11 11 2 0 0 0 0 0 0 0 0 0 0 30 30 30 30 30 0 0
0 0 20 0 0 0 0 0 5 0 0 0 0 0 0 0 0 0 0 0 0 0 1 11 11 11 11 11 11 11 11 11 11 11 11 11 3 0 0 35 30 30 30 34 0 0 0 1 11 11 11 11 11 11 11 11 2 0 0 0 0 0 0 35 30 30 30 34 0 0
0 15 17 0 37 31 36 0 0 0 7 0 0 0 0 0 1 11 11 11 11 11 11 11 11 11 11 11 11 11 41 30 30 30 40 3 0 0 7 0 0 29 0 0 0 0 1 11 11 11 11 11 11 11 11 11 11 11 11 2 0 0 0 0 0 29 0 0 0 0
0 20 0 37 30 30 31 36 0 0 6 0 0 0 0 1 11 11 11 11 11 11 11 11 3 0 0 20 0 0 30 30 30 30 30 0 0 0 6 0 26 27 28 0 0 0 11 11 11 11 11 41 30 30 30 40 11 11 11 11 11 2 0 0 26 27 28 0 0 0
0 20 0 31 30 30 30 31 0 0 0 0 0 0 1 11 11 11 11 11 11 11 11 3 0 0 0 20 0 0 30 30 30 30 30 0 0 0 0 0 0 0 0 0 0 1 11 11 11 3 0 30 30 30 30 30 11 11 11 11 11 11 0 0 0 0 0 0 0 0
0 20 0 35 32 31 32 34 0 0 0 5 0 1 11 11 11 3 0 0 0 0 0 0 0 0 0 20 0 0 30 30 30 30 30 0 0 0 0 0 0 0 0 0 0 11 11 11 11 0 0 30 30 30 30 30 7 4 11 11 11 11 0 0 0 0 0 0 0 0
0 20 0 0 35 33 34 0 0 0 5 0 1 11 11 11 3 0 0 0 0 0 0 0 0 0 0 20 0 0 35 30 30 30 34 0 0 0 0 0 0 0 0 0 1 11 11 11 3 7 5 30 30 30 30 30 6 0 4 11 11 11 2 0 5 0 0 0 0 0
0 20 0 0 22 23 24 0 0 0 0 1 11 11 11 3 0 0 0 0 0 0 0 0 0 0 0 20 0 0 0 22 23 24 0 0 37 30 31 30 36 0 0 0 11 11 11 11 0 6 0 35 30 30 30 34 0 5 0 11 11 11 11 0 0 0 0 0 0 0
0 20 0 8 0 0 0 0 0 0 1 11 11 11 3 0 0 37 30 31 30 36 0 8 0 0 15 17 0 0 9 0 0 0 0 0 30 30 30 30 30 0 0 0 11 11 11 11 0 10 8 0 0 29 0 0 0 7 0 11 11 11 11 0 0 7 0 0 9 0
0 20 0 0 0 0 0 0 0 1 11 11 11 3 0 0 0 30 32 33 32 33 0 0 0 0 20 0 0 0 0 0 0 0 5 0 30 30 30 30 30 0 0 0 11 11 11 11 5 0 0 0 26 27 28 0 7 6 0 11 11 11 11 0 0 6 0 0 0 0
0 20 0 0 0 0 5 0 0 11 11 11 3 0 0 0 0 31 30 31 32 31 0 0 7 0 20 0 5 0 0 0 0 0 0 0 30 30 30 30 30 0 0 0 11 11 11 11 0 0 7 0 0 0 0 0 6 0 0 11 11 11 11 0 0 0 0 7 0 0
0 18 16 0 0 0 0 0 0 11 11 11 0 0 0 5 0 31 32 33 32 33 0 7 6 0 20 0 0 0 0 0 0 0 0 0 35 30 30 30 34 0 0 0 11 11 11 11 2 0 6 0 7 0 5 0 0 0 1 11 11 11 3 0 0 0 0 6 0 0
0 0 20 0 0 0 0 0 0 11 11 11 0 0 0 0 0 35 30 31 30 34 0 6 0 15 17 37 30 30 30 36 0 0 0 0 0 0 29 0 0 0 0 0 4 11 11 11 11 0 0 0 6 0 0 0 1 11 11 11 11 11 37 30 30 30 36 0 0 0
0 0 20 0 7 0 0 0 1 11 11 11 0 0 9 0 0 0 0 29 0 0 0 0 0 20 0 30 30 30 30 30 0 0 0 0 0 0 29 0 0 0 0 0 0 11 11 11 11 2 5 0 0 0 1 11 11 11 11 11 11 3 30 30 30 30 30 0 0 5
5 0 20 0 6 0 0 1 11 11 11 3 0 0 0 0 0 0 26 27 28 0 0 0 0 20 0 30 30 30 30 30 0 0 0 0 0 26 27 28 0 0 0 0 0 4 11 11 11 11 11 11 11 11 11 11 11 11 11 11 11 0 30 30 30 30 30 0 0 0
0 0 20 0 0 0 1 11 11 11 3 0 0 0 0 0 7 0 0 0 0 0 0 0 0 20 0 30 30 30 30 30 0 0 0 0 0 0 0 0 0 0 0 0 0 0 11 11 11 11 11 11 11 11 11 11 11 11 11 11 3 0 30 30 30 30 30 0 0 0
7 0 20 0 0 1 11 11 11 3 0 0 0 0 0 0 6 0 0 0 0 0 0 15 19 17 0 35 30 30 30 34 0 0 0 0 0 0 0 0 0 0 0 0 0 0 4 11 11 11 11 11 11 11 11 11 11 3 0 0 0 0 35 30 30 30 34 0 0 0
6 0 0 0 1 11 11 11 3 0 0 0 0 0 0 0 0 0 0 15 19 19 19 17 0 0 0 0 0 25 0 0 0 0 0 0 0 0 7 0 0 0 0 5 0 0 0 0 0 4 11 11 11 11 3 0 0 0 0 0 0 0 0 0 25 0 0 0 0 0
0 0 0 1 11 11 11 3 0 0 0 0 15 19 19 19 19 19 19 17 0 0 0 0 0 0 10 8 0 25 5 0 0 0 0 0 0 7 6 0 0 0 0 0 0 0 0 0 0 0 0 0 0 0 7 0 0 0 0 0 0 0 0 22 23 24 7 0 0 0
0 0 1 11 11 11 3 0 15 19 19 19 17 0 0 0 0 0 0 0 0 0 0 0 0 0 0 0 22 23 24 0 0 0 0 0 0 6 0 0 0 0 0 0 0 0 0 0 0 0 0 0 0 0 6 0 0 0 5 0 0 0 0 0 0 0 6 0 7 0
0 1 11 11 11 3 0 0 0 0 0 0 0 0 0 0 5 0 0 0 0 0 0 0 0 0 0 0 0 0 0 0 0 0 0 0 0 0 0 0 0 0 0 0 0 0 0 0 0 10 8 0 0 0 0 0 0 5 0 0 0 0 0 0 0 0 0 0 6 0