50 50
23 23 23 23 23 23 23 23 23 8 8 8 8 8 8 8 8 8 8 8 8 8 23 23 23 23 23 23 23 -1 -1 -1 -1 -1 -1 -1 -1 -1 -1 -1 -1 -1 -1 -1 -1 -1 -1 -1 0 0
23 23 23 23 23 23 23 23 23 23 23 23 8 8 8 8 8 8 8 8 8 23 23 23 23 23 23 23 23 -1 -1 -1 -1 -1 -1 -1 -1 -1 -1 -1 -1 -1 -1 -1 -1 -1 -1 -1 0 0
23 23 23 23 23 23 23 23 23 23 23 23 23 8 8 8 8 8 8 23 23 23 23 23 23 23 23 23 23 -1 -1 -1 -1 -1 -1 -1 -1 -1 -1 -1 -1 -1 -1 -1 -1 -1 -1 -1 0 0
23 23 23 23 23 23 23 8 8 8 8 23 23 23 23 7 7 7 7 7 4 7 7 23 23 23 23 23 23 -1 -1 -1 -1 -1 -1 -1 -1 -1 -1 -1 -1 -1 -1 -1 -1 -1 -1 -1 0 0
23 23 23 23 23 23 23 8 8 8 8 8 8 23 23 7 7 7 23 23 23 23 23 23 23 23 23 23 23 -1 -1 -1 -1 -1 -1 -1 -1 -1 -1 -1 -1 -1 -1 -1 -1 -1 -1 -1 0 0
23 23 23 23 23 23 23 8 8 8 8 8 8 7 7 7 7 7 23 23 23 23 23 23 23 23 23 23 23 23 23 8 8 8 23 -1 -1 -1 -1 23 23 23 23 23 23 23 23 23 23 23
23 23 23 23 23 23 23 23 23 8 8 8 23 23 23 7 7 7 23 23 23 23 23 23 23 2 2 2 2 2 8 8 8 8 8 23 23 23 23 8 8 8 2 2 2 2 2 2 2 2
2 2 2 2 2 2 2 2 2 2 2 2 2 23 23 7 7 7 23 2 14 14 14 14 2 2 2 2 2 8 8 8 8 8 8 2 2 2 8 8 8 8 8 2 2 2 2 2 2 2
3 0 0 0 0 0 0 0 0 0 0 2 2 2 2 7 7 7 2 0 2 14 14 14 2 2 2 2 2 8 8 8 8 8 8 8 0 0 8 8 8 8 8 2 2 2 2 2 2 2
0 0 0 0 0 15 0 0 0 0 9 0 0 0 0 7 7 7 0 0 14 14 14 14 1 0 0 0 0 8 8 8 8 8 8 8 0 0 0 8 8 8 0 0 0 0 0 0 0 0
0 10 0 0 0 0 0 0 0 0 0 8 8 8 13 7 7 7 0 0 14 14 14 14 14 0 15 0 0 0 8 8 8 8 8 0 0 9 0 0 4 0 0 0 0 0 9 0 0 0
0 0 0 9 0 0 0 10 0 0 8 8 8 8 8 12 12 12 0 0 0 14 14 14 14 0 0 0 0 0 0 8 8 8 0 3 0 0 0 5 7 0 13 0 0 0 0 0 0 0
0 0 0 0 0 0 0 0 0 8 8 8 8 8 8 8 0 13 0 0 14 14 14 14 14 0 0 0 0 0 0 0 7 6 0 0 0 0 0 0 12 0 0 0 0 0 0 0 0 0
0 0 9 0 3 0 0 0 0 8 8 8 8 8 8 8 0 0 0 13 14 14 14 14 0 0 0 10 0 0 0 0 7 0 0 0 0 0 0 0 0 10 0 0 0 0 0 0 0 0
0 0 0 0 0 0 0 0 15 8 8 8 8 8 8 8 0 0 0 0 14 14 14 14 14 0 0 0 0 10 0 0 7 0 0 0 0 0 0 0 0 0 0 0 0 0 0 0 0 0
0 15 0 0 0 0 15 15 15 15 8 8 8 8 8 15 15 0 0 0 0 14 14 14 14 14 14 0 0 0 0 0 12 0 0 0 15 0 0 0 0 0 0 0 0 0 0 0 0 0
0 0 0 0 15 15 15 15 0 0 0 8 8 8 0 15 15 15 0 2 2 14 14 14 14 14 14 14 0 0 0 0 0 13 0 0 0 0 0 0 0 9 9 0 0 0 0 0 0 0
0 15 15 15 15 15 0 0 0 0 5 11 4 0 11 0 0 0 2 2 2 2 14 14 14 14 14 14 14 14 14 0 0 0 0 0 0 0 0 0 0 0 0 0 0 0 0 3 0 0
15 15 15 15 0 0 0 5 0 0 0 0 7 0 0 0 2 2 2 2 2 0 0 14 14 14 14 14 14 14 14 14 14 14 0 0 0 0 0 0 0 0 0 0 0 0 0 0 0 0
15 15 0 0 0 0 0 0 0 2 14 2 4 6 2 2 2 2 2 2 2 15 15 0 0 14 14 14 14 14 14 14 14 14 14 14 0 0 10 0 15 0 0 0 0 0 0 0 0 0
15 0 0 0 0 0 0 2 2 2 2 14 7 1 14 2 2 2 2 2 0 0 15 15 0 0 0 14 14 14 14 14 14 14 14 14 14 0 0 0 0 0 0 8 8 8 8 0 9 0
0 0 0 0 11 0 0 2 2 2 14 2 2 14 2 2 2 2 2 2 2 0 15 15 0 9 0 0 0 14 14 14 14 14 14 14 14 14 0 0 0 0 8 8 8 8 8 8 0 0
0 0 0 0 0 0 2 2 2 2 2 2 14 2 2 2 2 2 2 2 2 0 15 15 0 0 0 0 0 0 0 0 14 14 14 14 14 14 14 0 0 0 8 8 8 8 8 8 8 0
0 0 8 8 8 0 2 2 2 2 2 2 2 2 2 2 2 2 2 2 2 0 15 15 0 0 3 0 0 0 0 9 0 0 14 14 14 14 14 0 0 0 8 8 8 8 8 8 8 0
0 8 8 8 8 8 2 2 2 2 2 2 2 2 2 2 2 8 8 8 2 0 0 15 15 0 0 0 15 0 0 0 0 0 14 14 14 14 14 0 0 0 8 8 8 8 8 8 0 0
0 8 8 8 8 8 0 2 2 2 2 2 2 2 2 2 8 8 8 8 8 0 0 15 15 0 0 0 0 0 0 0 0 0 0 14 14 14 14 14 0 9 0 8 8 8 8 8 0 10
0 8 8 8 8 8 0 2 2 2 2 2 2 2 2 2 8 8 8 8 8 0 0 15 15 8 0 0 10 0 0 3 0 0 0 14 14 14 14 14 0 0 0 0 0 7 0 0 0 0
0 0 8 8 8 0 0 2 2 2 2 2 2 2 2 2 2 8 8 8 0 0 0 15 8 8 8 0 0 0 0 0 0 0 14 14 14 14 14 0 0 3 0 9 0 7 11 8 0 0
0 0 0 7 0 0 0 0 2 2 2 2 2 2 2 2 2 2 7 0 0 0 0 15 8 8 8 0 0 0 0 0 14 14 14 14 14 14 14 0 0 0 0 0 5 7 0 0 10 0
0 0 5 7 0 0 0 0 0 0 0 0 2 2 2 2 2 0 12 0 0 0 15 15 0 8 0 0 0 0 0 14 14 14 14 14 14 14 14 0 0 0 0 0 13 7 0 0 0 15
0 0 0 7 6 0 0 0 0 0 0 0 0 0 0 0 0 0 0 0 0 15 15 0 0 7 13 0 0 0 14 14 14 14 14 14 14 14 0 0 0 0 0 0 0 12 0 13 0 0
0 0 0 12 0 0 0 7 7 4 7 7 0 0 0 0 0 0 15 15 15 15 0 0 0 12 0 0 14 14 14 14 14 14 14 14 14 0 0 0 0 0 15 0 0 0 0 0 0 0
0 0 0 0 0 0 0 0 0 0 0 0 0 0 0 15 15 15 15 15 0 0 0 0 0 0 0 14 14 14 14 14 14 14 14 0 0 0 0 0 10 0 0 0 0 0 0 0 0 0
0 0 0 0 0 0 15 15 15 15 15 15 15 15 15 15 15 15 0 0 0 0 0 0 0 14 14 14 14 14 14 14 14 14 0 0 0 0 0 0 0 10 0 0 0 0 0 3 0 0
0 0 0 15 15 15 15 15 15 15 15 15 15 15 15 15 15 0 0 0 0 0 0 0 14 14 14 14 14 14 14 14 0 0 0 3 0 9 0 0 0 0 0 0 0 0 0 0 0 0
0 15 15 15 0 0 0 0 0 0 0 0 0 15 15 15 15 15 0 0 0 0 0 14 14 14 14 14 14 14 14 2 0 0 0 0 0 0 0 0 0 0 8 8 8 0 0 0 0 0
15 15 0 0 0 0 8 8 8 0 0 0 0 0 0 0 15 15 15 15 7 14 14 14 14 14 14 14 14 14 2 2 2 0 0 0 5 6 0 0 0 8 8 8 8 8 0 0 9 0
15 0 0 0 0 8 8 8 8 8 0 0 10 0 0 0 0 15 15 14 7 14 14 14 14 14 14 14 0 2 2 2 2 2 0 0 2 0 2 0 0 8 8 8 8 8 0 0 0 0
0 0 9 0 0 8 8 8 8 8 0 0 0 0 0 0 0 0 14 14 4 14 14 14 14 14 0 0 0 0 2 2 2 2 2 2 2 2 0 2 2 0 8 8 8 0 9 0 0 0
0 0 0 0 0 0 8 8 8 0 0 0 0 0 0 0 14 14 14 14 7 14 14 14 0 0 0 0 3 0 0 2 2 2 2 2 2 2 2 2 2 0 0 7 0 0 0 9 0 0
0 0 0 0 0 0 0 7 6 0 0 0 0 0 14 14 14 14 14 14 7 15 15 0 0 0 10 0 0 0 0 0 2 2 2 2 2 2 2 2 2 0 0 12 0 0 0 0 0 0
0 0 8 8 8 0 0 12 13 0 0 0 0 14 14 14 14 14 14 1 0 15 15 15 0 0 0 0 0 0 0 2 2 2 2 2 2 2 2 2 2 2 2 0 0 0 0 8 0 0
0 8 8 8 8 8 0 0 0 0 0 0 14 14 14 14 14 14 0 0 0 13 15 15 15 0 0 0 8 8 8 0 2 2 2 2 14 14 2 2 2 2 0 2 0 0 8 8 8 0
0 8 8 8 8 8 0 0 0 0 0 14 14 14 14 14 0 0 0 0 0 0 0 15 15 0 0 8 8 8 8 8 0 2 2 2 14 14 14 2 2 2 2 0 0 8 8 8 8 8
0 0 8 8 8 0 0 0 0 0 14 14 14 14 14 0 0 0 0 0 10 0 0 15 15 15 0 8 8 8 8 8 0 2 2 2 2 14 2 2 2 2 2 0 0 0 8 8 8 0
0 0 0 7 0 0 0 0 0 0 14 14 14 14 14 0 0 0 9 0 0 0 0 0 15 15 0 0 8 8 8 0 2 2 2 2 2 2 2 2 2 2 0 13 0 8 8 8 8 8
0 0 0 4 0 0 0 9 0 14 14 14 14 14 0 0 0 0 0 0 0 0 0 0 15 15 0 0 0 7 0 0 0 2 2 2 2 2 2 2 2 2 0 0 0 0 8 8 8 0
0 0 0 12 0 0 0 0 0 14 14 14 14 0 0 18 17 19 0 0 0 5 6 0 15 15 0 0 0 7 0 0 0 0 0 2 0 2 2 2 0 2 0 0 0 8 8 8 8 8
0 0 0 0 0 0 0 0 14 14 14 14 14 0 0 21 16 20 0 0 0 0 0 0 15 15 0 0 0 12 0 0 0 0 3 0 2 2 2 0 2 0 0 0 0 0 0 12 0 0
0 0 0 0 0 0 0 0 14 14 14 14 14 0 13 16 22 16 0 0 0 0 0 0 15 15 0 13 0 0 0 0 0 9 0 0 0 0 0 0 0 5 6 0 0 0 0 0 0 0