90 64
62 62 62 62 62 62 62 62 62 75 31 31 31 74 55 60 0 0 0 0 37 30 30 30 36 0 0 0 30 30 30 30 30 0 0 0 0 0 0 0 37 32 32 32 36 0 0 0 0 0 0 0 0 0 0 0 0 0 0 0 0 0 0 37 30 30 30 36 0 0 0 0 0 0 0 0 0 0 0 0 0 0 0 0 0 0 0 0 0 0
62 62 62 62 84 62 62 62 62 87 62 29 62 62 55 60 0 5 0 0 30 30 30 30 30 0 0 0 30 30 30 30 30 0 0 9 0 0 0 0 32 32 32 32 32 0 0 0 0 7 0 0 0 0 0 0 0 0 0 0 0 0 0 33 30 33 30 30 0 7 0 0 0 37 33 30 30 36 0 0 0 0 0 0 0 0 0 0 0 0
11 11 11 11 11 11 64 62 62 62 81 82 83 62 55 60 0 0 0 0 30 30 30 30 30 0 0 0 35 30 30 30 34 0 0 0 0 0 0 0 32 32 32 32 32 0 0 7 0 6 0 0 0 0 0 0 0 0 0 0 0 0 0 30 33 30 33 33 0 6 0 7 0 30 30 30 30 30 0 0 0 0 0 0 0 0 0 0 0 0
11 11 11 11 11 11 11 11 64 62 62 62 62 58 53 51 0 0 0 0 30 30 30 30 30 0 5 0 0 0 29 0 0 0 0 0 0 0 0 0 32 32 32 32 32 0 0 6 0 0 0 0 0 0 0 0 0 0 5 0 0 0 0 30 30 33 30 30 0 0 0 6 0 33 30 33 30 33 0 0 0 7 0 0 0 0 0 0 0 0
11 11 11 11 11 11 11 11 11 11 11 64 62 55 60 0 0 0 0 0 35 30 30 30 34 0 0 0 0 0 29 0 0 0 0 5 0 0 0 0 35 32 32 32 34 0 0 0 0 0 37 30 30 30 36 0 0 0 5 0 0 0 0 35 30 33 30 34 0 0 0 0 0 30 33 30 30 30 0 0 0 6 0 0 0 0 0 0 0 0
62 62 62 62 62 66 11 11 11 11 11 11 64 55 60 0 0 0 0 5 0 0 25 0 0 0 10 8 0 26 27 28 0 0 5 0 5 0 0 0 0 0 25 0 0 0 0 0 0 0 30 30 30 30 30 0 0 0 0 0 5 0 0 0 26 27 28 0 0 0 0 0 0 35 33 30 33 34 0 0 0 0 0 0 0 0 0 0 0 0
86 62 62 62 62 62 62 62 66 11 11 11 65 53 51 0 0 0 0 0 5 0 25 0 0 0 0 0 0 0 0 0 0 0 0 5 0 0 0 0 9 0 25 0 8 0 0 0 0 0 30 30 30 30 30 0 0 0 0 0 0 0 5 0 0 0 0 0 0 0 0 0 8 0 0 25 0 0 0 0 0 0 0 0 0 0 0 0 0 0
85 62 62 62 86 62 62 62 62 62 66 65 53 51 0 0 0 0 5 0 0 22 23 24 0 0 37 30 30 30 36 0 0 0 0 0 0 0 0 10 0 0 25 0 10 0 0 0 0 0 30 30 30 30 30 0 0 0 0 0 0 0 0 0 0 0 37 30 33 30 36 0 0 0 22 23 24 0 5 0 37 30 30 33 36 0 0 7 0 0
62 62 62 62 85 62 62 62 62 58 57 53 51 0 1 2 0 0 0 0 0 0 0 0 0 0 30 30 30 30 30 0 0 0 0 0 0 0 0 0 0 22 23 24 0 0 0 0 0 0 35 30 30 30 34 0 0 0 37 30 33 30 36 0 0 0 30 30 33 30 30 0 0 0 0 0 0 0 0 0 30 33 33 30 30 0 0 6 7 0
62 84 62 62 62 62 58 57 57 53 50 51 0 1 11 11 0 0 0 0 0 0 0 0 0 0 30 30 30 30 30 0 0 0 0 0 0 0 0 0 0 0 0 0 0 0 0 0 0 0 0 0 29 0 9 0 0 0 30 30 30 30 30 0 0 0 33 30 30 30 33 0 37 30 33 30 36 0 0 0 33 30 30 33 33 0 0 0 6 0
57 57 57 57 57 57 53 50 50 51 0 0 0 11 11 11 2 0 0 0 0 0 0 0 0 0 30 30 30 30 30 0 0 0 0 0 0 0 0 0 0 0 0 0 0 0 0 0 7 0 0 26 27 28 0 0 0 0 33 30 33 30 33 0 0 0 30 30 33 30 30 0 30 30 30 33 30 0 0 0 30 30 33 30 30 0 0 0 0 0
50 50 50 50 50 50 51 0 0 0 0 0 0 4 11 11 11 0 0 0 0 0 0 0 0 0 35 30 30 30 34 0 0 7 0 37 30 30 30 36 0 0 0 0 0 0 0 0 6 0 0 0 0 0 0 0 0 0 30 30 30 30 30 0 9 0 35 30 33 30 34 7 30 33 30 30 30 0 0 0 35 33 30 30 34 0 0 0 0 0
0 0 0 7 0 0 0 0 0 0 0 0 0 0 11 11 11 0 0 0 0 0 0 0 0 7 0 0 25 0 0 0 0 6 0 30 30 30 30 30 0 0 0 0 0 0 7 0 0 0 7 0 0 5 0 0 0 0 35 33 33 30 34 0 8 0 0 22 23 24 0 6 30 33 30 33 30 0 0 0 0 0 25 0 0 0 0 0 0 0
0 0 7 6 0 0 0 0 0 0 0 0 0 0 11 11 11 0 0 0 9 0 0 0 0 6 0 22 23 24 0 0 0 0 0 30 30 30 30 30 0 0 0 0 0 0 6 0 0 0 6 0 0 0 0 0 0 0 0 0 25 0 0 0 0 37 30 30 33 36 0 0 35 33 30 30 34 0 0 0 0 9 25 10 0 0 0 0 0 0
0 0 6 0 0 7 0 0 0 0 0 0 0 0 11 11 11 0 0 0 0 0 0 0 0 0 0 0 0 0 0 0 0 0 0 30 30 30 30 30 0 0 0 0 0 0 0 0 5 0 0 0 7 7 0 0 0 0 0 0 25 0 0 0 0 33 30 30 30 30 0 0 0 0 29 0 0 0 0 0 0 22 23 24 0 0 0 0 0 0
0 7 0 0 0 6 0 0 0 0 0 0 0 0 11 11 11 0 0 0 0 0 0 0 0 0 0 0 0 0 0 0 0 0 0 35 30 30 30 34 0 0 0 0 7 0 0 0 0 0 0 0 6 6 0 0 0 0 0 22 23 24 0 0 0 33 30 33 30 33 0 0 0 0 29 0 0 0 0 0 0 0 0 0 0 0 0 0 0 0
0 6 7 0 0 0 0 37 32 32 32 36 0 0 11 11 11 2 0 0 37 30 30 30 36 0 0 0 0 0 0 0 0 0 0 0 0 29 0 0 0 0 0 0 6 0 0 7 0 0 0 0 0 0 0 0 0 0 0 0 0 0 0 0 7 30 30 33 30 30 0 0 0 26 27 28 0 0 0 0 7 0 37 30 30 30 36 0 0 0
0 0 6 0 7 0 0 30 30 30 30 30 0 0 4 11 11 11 0 0 30 30 30 30 30 0 0 0 0 0 0 0 0 0 0 0 26 27 28 0 0 0 0 0 0 0 0 6 7 0 0 0 0 0 0 0 0 0 0 0 0 0 0 0 6 35 30 30 30 34 0 0 0 5 0 0 0 0 0 7 6 0 30 30 30 33 30 0 0 0
0 0 0 0 6 0 0 30 30 30 30 30 0 0 0 11 11 11 0 0 30 30 30 30 30 0 0 0 0 0 0 7 0 0 0 0 0 0 0 0 0 0 0 0 0 0 0 0 6 0 0 0 7 0 0 5 0 0 0 0 0 0 0 0 0 0 0 29 0 0 0 0 0 0 0 0 0 0 0 6 0 0 33 30 30 30 30 0 0 0
0 0 0 0 0 0 0 30 30 30 30 30 0 0 0 11 11 11 0 0 30 30 30 30 30 0 0 0 0 0 7 6 0 0 0 0 0 0 0 0 0 0 0 0 0 0 0 0 0 0 0 0 6 0 0 0 0 0 0 0 0 0 0 0 0 0 26 27 28 0 0 0 0 0 0 0 0 0 0 0 0 0 30 30 33 30 30 7 0 0
0 0 0 0 0 0 0 35 30 30 30 34 0 0 1 11 11 11 0 0 35 30 30 30 34 0 0 0 0 0 6 0 0 0 0 0 0 0 0 0 0 0 0 0 0 0 0 0 0 0 0 0 0 0 0 0 0 0 0 0 0 0 0 0 0 0 0 0 0 0 0 0 0 0 0 0 0 0 0 0 0 0 35 30 33 30 34 6 0 0
0 0 0 0 0 0 8 0 0 25 0 0 0 0 11 11 11 3 0 0 0 26 27 28 0 8 0 0 0 0 0 0 0 0 0 0 0 0 0 0 0 0 0 0 0 0 0 0 0 0 0 0 0 0 0 0 0 0 0 0 0 0 0 0 0 0 69 67 67 67 67 67 68 0 0 0 0 0 0 0 0 0 5 0 25 0 0 0 0 0
0 0 37 31 30 32 36 0 22 23 24 0 0 0 11 11 11 0 0 0 0 0 0 0 0 0 0 0 0 0 0 0 0 0 0 0 0 0 0 69 67 67 67 67 67 67 67 67 67 67 67 67 67 67 67 68 0 0 0 0 0 0 69 67 67 67 72 62 62 62 62 62 73 67 67 68 0 0 0 0 5 5 0 22 23 24 0 0 0 0
0 0 31 30 32 31 30 0 0 0 0 0 0 1 11 11 11 0 0 0 0 0 7 0 0 0 0 0 0 0 0 69 67 67 67 67 67 67 67 72 62 62 62 62 62 62 62 62 85 62 62 62 62 62 62 73 67 67 67 67 67 67 72 62 62 62 62 62 62 84 62 62 62 62 62 73 67 68 0 0 0 5 0 0 0 7 7 0 0 0
0 0 31 31 32 32 31 0 0 0 0 0 0 11 11 11 3 0 0 0 0 7 6 0 0 0 0 0 69 67 67 72 62 62 62 89 62 62 86 62 62 62 62 62 62 62 86 62 62 86 62 62 62 62 62 62 62 62 62 62 62 62 62 62 62 62 62 62 84 62 62 62 62 62 62 62 62 73 67 68 0 0 0 0 0 6 6 0 0 0
0 0 30 31 31 30 32 0 0 0 0 0 0 11 11 11 0 20 0 0 0 6 0 0 0 0 69 67 72 62 84 62 77 30 30 30 76 62 85 62 86 62 62 62 62 62 85 62 62 85 62 62 62 62 84 62 84 62 62 62 86 62 62 62 62 86 62 62 62 62 62 62 62 62 62 62 89 62 62 73 67 68 0 0 0 0 0 0 0 0
0 0 35 32 30 30 34 0 0 0 20 0 0 11 11 11 0 20 10 0 0 0 0 0 0 69 77 30 30 30 76 62 30 30 30 30 30 62 62 62 85 62 62 62 62 62 62 62 62 62 62 62 62 62 62 84 62 62 62 62 85 62 62 62 62 85 62 86 62 62 62 62 62 62 62 62 62 62 62 62 62 73 68 0 0 0 0 0 0 0
0 0 0 0 29 0 0 0 15 19 17 0 0 11 11 11 0 18 19 16 0 0 0 0 0 70 30 30 30 30 30 62 30 30 30 30 30 62 62 62 62 62 62 62 62 62 62 77 30 30 30 76 62 62 62 62 62 84 62 62 62 62 62 62 62 62 62 85 86 86 62 62 62 62 62 62 62 62 62 62 62 62 73 68 0 0 0 0 0 0
0 0 0 0 29 0 10 0 20 0 0 0 0 11 11 11 0 0 0 18 16 0 0 0 69 72 30 30 30 30 30 62 30 30 30 30 30 62 77 30 30 30 76 62 84 62 62 30 30 30 30 30 62 62 62 62 62 62 62 62 62 62 62 62 62 89 62 62 85 85 62 62 62 62 62 62 62 77 30 30 30 76 62 71 0 0 0 0 0 0
0 0 0 26 27 28 0 15 17 0 1 11 11 11 11 11 11 2 0 0 18 19 0 0 70 62 30 30 30 30 30 62 75 30 30 31 74 62 30 30 30 30 30 62 62 62 62 30 30 30 30 30 62 62 62 62 62 62 62 62 62 62 62 62 62 62 62 62 62 62 62 62 62 62 62 62 62 30 30 30 30 30 62 73 68 0 0 0 0 0
0 0 0 7 0 0 0 0 0 1 11 11 11 11 11 11 11 11 11 2 0 0 0 0 70 62 75 30 30 30 74 62 62 62 25 62 62 62 30 30 30 30 30 62 62 84 62 30 30 30 30 30 62 62 62 62 86 62 62 62 62 62 62 62 62 62 62 62 62 62 62 62 62 62 62 62 62 30 30 30 30 30 62 62 71 0 0 37 31 30
0 7 0 6 0 0 0 1 11 11 11 11 11 11 11 11 11 11 11 11 11 2 0 0 70 62 62 62 29 62 62 62 86 78 79 80 62 62 30 30 30 30 30 62 84 62 62 75 30 30 30 74 62 62 62 62 85 62 62 62 62 62 62 63 11 11 11 11 11 11 11 64 62 62 62 62 62 30 30 30 30 30 62 62 71 0 0 30 30 33
0 6 0 0 0 0 1 11 11 11 11 11 11 11 11 11 11 11 11 11 11 11 2 69 72 62 62 81 82 83 62 86 85 62 62 62 62 62 75 30 30 30 74 62 62 84 62 62 62 29 62 87 62 62 62 62 62 62 62 62 63 11 11 11 11 11 11 11 11 11 11 11 11 11 64 62 62 75 30 30 30 74 62 62 71 0 0 33 33 30
0 0 0 0 0 0 11 11 11 11 11 11 11 11 11 11 11 11 11 11 11 11 11 70 62 62 62 62 62 62 62 85 62 62 62 62 62 62 62 62 25 62 62 62 62 62 62 62 81 82 83 62 62 62 62 62 62 62 62 63 11 11 11 11 11 11 11 11 11 11 11 11 11 11 11 62 62 62 62 25 62 62 62 62 73 68 0 30 30 33
0 0 0 0 0 1 11 11 11 11 11 11 11 11 11 11 11 11 11 11 11 11 11 64 62 62 62 62 62 62 62 62 62 62 62 62 62 62 62 78 79 80 62 62 62 62 62 62 62 62 62 62 62 62 62 62 62 62 62 11 11 11 11 11 11 11 11 11 11 11 11 11 11 11 11 64 62 62 78 79 80 62 62 62 62 71 0 35 30 31
31 31 31 36 0 11 11 11 11 11 11 11 11 11 11 11 11 11 11 11 11 11 11 11 11 11 11 11 11 11 11 11 11 11 11 11 64 62 62 62 62 62 62 62 62 62 62 62 62 62 62 62 62 84 62 62 62 62 63 11 11 11 11 11 11 11 11 11 11 11 11 11 11 11 11 11 62 62 62 62 62 62 62 62 62 71 0 0 0 25
31 31 31 31 0 11 11 11 11 11 11 11 11 11 11 11 11 11 11 11 11 11 11 11 11 11 11 11 11 11 11 11 11 11 11 11 11 11 11 11 11 11 11 11 11 11 64 62 62 62 62 62 62 62 62 62 62 62 11 11 11 11 11 11 11 11 11 11 11 11 11 11 11 11 11 11 62 62 62 62 62 86 62 62 62 71 0 0 0 25
31 31 31 31 0 11 11 11 11 11 11 11 11 11 11 11 11 11 11 11 11 11 11 11 11 11 11 11 11 11 11 11 11 11 11 11 11 11 11 11 11 11 11 11 11 11 11 11 11 11 11 11 11 11 11 11 11 11 11 11 11 11 11 11 11 11 11 11 11 11 11 11 11 11 11 11 64 62 62 62 62 85 62 86 86 71 0 0 22 23
31 31 31 31 0 11 11 11 11 11 11 11 11 11 11 11 11 11 11 11 11 11 11 11 62 62 62 62 62 77 30 30 30 76 62 66 11 41 30 30 30 40 11 11 11 11 11 11 11 11 11 11 11 11 11 11 11 11 11 11 11 11 11 11 11 11 11 11 11 11 11 11 11 11 11 11 11 62 62 62 62 62 62 85 85 71 0 0 0 0
31 31 31 34 0 4 11 11 11 11 11 11 11 11 11 11 11 11 11 11 11 11 11 65 62 62 62 62 62 30 30 30 30 30 62 62 62 30 30 30 30 30 62 62 62 66 11 11 11 11 11 11 11 11 11 11 11 11 11 11 11 11 11 11 11 11 11 11 11 11 11 11 11 11 11 11 11 62 62 84 84 62 62 62 62 71 0 0 7 0
0 25 0 0 20 0 11 11 11 11 11 11 11 11 11 11 11 11 11 11 11 11 11 52 54 59 86 62 62 30 30 30 30 30 62 84 62 30 30 30 30 30 62 62 62 77 30 30 30 76 62 62 62 62 62 62 62 66 11 11 11 11 11 11 11 11 11 11 11 11 11 11 11 11 11 11 11 62 62 62 62 62 62 62 62 71 0 0 6 0
0 25 0 0 20 0 4 11 11 11 11 11 11 11 11 11 11 11 11 11 11 11 3 0 61 56 85 62 62 30 30 30 30 30 62 62 62 30 30 30 30 30 88 62 62 30 30 30 30 30 62 62 62 62 62 62 62 62 11 11 11 11 11 11 11 11 11 11 11 11 11 11 11 11 11 11 65 62 62 62 62 86 62 84 62 71 0 7 0 0
22 23 24 0 18 16 0 11 11 11 11 11 11 11 11 11 11 11 11 11 11 11 0 0 61 56 62 62 62 75 30 30 30 74 62 62 62 75 30 30 30 74 62 86 62 30 30 30 30 30 62 62 84 62 62 62 62 62 11 11 11 11 11 11 11 11 11 11 11 11 11 11 11 11 11 11 62 62 62 62 62 85 62 62 62 71 0 6 0 0
0 0 0 0 0 18 16 4 11 11 11 11 11 11 11 11 11 11 11 11 11 3 0 0 61 56 62 62 84 62 62 25 62 62 62 62 62 62 78 79 80 62 62 85 62 30 30 30 30 30 62 62 62 62 62 62 62 62 66 11 11 11 11 11 11 11 11 11 11 11 11 11 11 11 11 41 30 30 30 76 62 62 62 62 58 53 0 0 0 0
0 0 0 0 0 0 20 37 30 30 30 40 11 11 11 11 11 11 11 11 3 0 0 0 52 54 59 62 62 62 78 79 80 62 62 86 62 62 62 62 62 62 62 62 62 75 30 30 30 74 62 62 62 62 62 62 62 62 62 66 11 11 11 11 11 11 11 11 11 11 11 11 11 11 11 30 30 30 30 30 62 62 62 62 55 60 0 0 0 0
0 0 0 0 0 0 0 30 30 30 30 30 11 11 11 11 11 11 11 11 2 0 0 0 0 52 54 59 62 62 62 87 62 62 62 85 62 86 62 62 62 62 62 62 62 62 62 25 62 62 62 62 62 62 86 62 62 62 62 62 66 11 11 11 11 11 11 11 11 11 11 11 11 11 11 30 30 30 30 30 62 62 62 62 55 60 0 0 0 0
0 0 0 0 0 0 0 30 30 30 30 30 0 0 0 0 0 4 11 11 11 2 0 0 0 0 52 54 57 59 62 62 62 62 62 62 62 85 62 62 62 62 62 62 62 62 78 79 80 62 62 62 62 86 85 62 62 62 62 62 62 62 66 11 11 11 11 11 11 11 11 11 11 11 65 30 30 30 30 30 62 62 62 58 53 51 0 0 0 0
0 0 5 0 0 0 0 30 30 30 30 30 0 19 19 19 16 0 4 11 11 11 2 0 0 0 0 52 50 54 57 57 57 59 62 62 62 62 62 62 84 62 62 62 62 84 62 62 62 62 62 62 62 85 62 62 62 62 62 62 62 62 62 62 66 11 11 11 11 11 11 11 65 62 62 75 30 30 30 74 62 62 62 55 60 0 0 10 0 0
0 0 0 0 0 0 0 35 30 30 30 34 0 0 0 0 18 16 0 4 11 11 11 0 0 0 0 0 0 52 50 50 50 54 57 57 57 62 62 62 62 62 62 62 62 62 62 62 62 62 62 62 62 62 62 62 62 62 62 62 62 62 62 62 62 62 62 62 62 62 62 62 62 62 62 62 62 29 62 62 62 62 58 53 51 0 9 0 8 0
0 0 37 30 30 30 36 0 26 27 28 0 0 0 0 5 0 20 0 0 11 11 11 0 0 0 20 0 0 0 0 0 0 52 50 50 50 54 57 57 57 57 57 59 84 62 62 62 62 62 62 62 62 62 62 62 62 62 62 62 62 62 62 62 62 62 62 62 62 62 84 84 62 62 62 62 62 29 87 62 62 62 55 60 0 0 0 0 0 0
0 0 30 30 30 30 30 0 0 0 0 0 0 0 0 0 0 20 0 0 11 11 11 0 0 0 20 0 0 5 0 0 0 0 0 0 0 52 50 50 50 50 50 54 57 57 57 57 57 59 62 62 62 62 62 62 62 62 84 62 62 62 86 62 62 62 62 62 62 62 62 62 84 62 62 62 81 82 83 62 62 58 53 51 0 0 0 0 0 0
0 0 30 30 30 30 30 0 0 0 7 0 0 0 0 0 0 18 16 0 11 11 11 0 0 0 20 0 0 0 5 0 0 0 0 0 0 0 0 0 0 0 0 52 50 50 50 50 50 54 57 57 57 59 62 62 62 62 62 62 62 62 85 62 86 62 62 84 84 62 62 62 62 62 62 62 62 62 62 62 58 53 51 0 0 0 0 7 0 0
0 0 30 30 30 30 30 0 0 0 6 0 0 0 0 0 0 0 20 0 11 11 11 2 0 0 18 16 0 0 0 0 0 0 7 0 0 0 5 0 0 5 0 0 0 0 0 0 0 52 50 50 50 54 57 57 59 62 62 62 62 62 62 62 85 62 62 62 62 62 84 62 62 62 84 62 62 62 62 62 55 60 0 0 0 7 0 6 0 0
0 0 35 30 30 30 34 0 0 0 0 0 0 0 0 0 0 0 20 0 4 11 11 11 0 0 0 20 0 0 0 0 0 7 6 0 0 0 0 5 0 37 31 30 31 36 0 0 0 0 0 0 0 52 50 50 54 57 57 59 62 62 62 62 62 62 62 62 62 62 62 84 62 62 62 62 62 58 57 57 53 51 0 0 0 6 0 0 0 0
0 0 0 0 25 0 0 0 37 30 30 30 36 0 0 0 0 0 20 0 0 11 11 11 0 0 0 20 0 0 0 0 0 6 0 0 0 0 0 0 0 31 31 31 31 30 0 0 0 7 0 0 0 0 0 0 52 50 50 54 57 57 57 59 62 62 62 62 62 84 62 62 58 57 57 57 57 53 50 50 51 37 33 31 30 36 0 0 7 0
0 0 0 22 23 24 0 0 30 30 30 30 30 0 5 0 0 0 20 0 0 11 11 11 2 0 0 20 0 0 0 0 0 0 0 0 0 0 0 0 0 31 30 31 30 31 0 0 7 6 0 0 0 37 30 33 30 36 0 52 50 50 50 54 57 57 57 57 57 57 57 57 53 50 50 50 50 51 0 0 0 30 30 31 30 30 0 7 6 0
0 0 0 0 0 0 0 0 30 30 30 30 30 0 0 0 0 0 20 0 0 4 11 11 11 0 0 20 0 0 0 0 0 37 30 30 32 36 0 0 0 30 31 31 31 31 0 0 6 0 0 0 0 30 32 33 30 30 0 0 0 0 0 52 50 50 50 50 50 50 50 50 51 0 0 0 0 0 0 7 0 30 33 30 30 31 0 6 0 0
0 0 0 0 0 5 0 0 30 30 30 30 30 0 0 0 0 0 0 0 0 0 11 11 11 0 0 18 16 0 0 0 0 30 32 30 30 30 0 0 0 35 31 30 31 34 0 0 0 0 7 0 0 33 30 30 33 32 0 0 0 0 0 0 0 0 0 0 0 0 0 0 0 0 0 0 0 0 0 6 0 31 30 33 30 30 0 0 0 0
0 0 0 7 0 0 0 0 35 30 30 30 34 0 0 0 0 0 0 0 0 0 11 11 11 0 0 0 20 0 0 0 0 32 32 30 32 32 0 0 0 0 0 25 0 0 0 0 0 0 6 0 0 32 32 30 30 30 0 0 0 0 0 0 0 0 0 7 0 0 0 0 5 0 0 5 0 0 0 0 0 35 30 31 30 34 0 0 0 0
0 0 0 6 0 7 0 0 0 0 29 0 0 0 0 0 0 0 0 0 0 0 11 11 11 0 0 0 20 0 0 0 0 30 30 32 30 30 0 0 0 7 0 25 0 0 0 0 0 0 0 0 0 35 30 33 32 34 0 0 0 0 0 0 0 0 7 6 0 0 0 0 0 0 5 0 0 0 0 0 0 0 0 25 0 0 0 0 0 0
0 0 0 0 0 6 0 0 0 26 27 28 0 0 0 0 0 0 0 0 0 0 11 11 11 0 0 0 20 0 0 0 0 35 32 30 30 34 0 0 0 6 22 23 24 0 0 5 0 0 0 0 0 0 0 29 0 0 0 0 0 0 0 7 0 0 6 0 0 0 0 0 0 0 0 0 0 0 0 0 0 0 22 23 24 0 0 0 0 0
0 0 0 0 0 0 0 0 0 0 0 0 0 0 0 0 0 5 0 0 0 0 11 11 11 0 0 0 0 0 0 0 0 0 22 23 24 0 0 0 0 0 0 0 0 0 0 0 0 5 0 0 0 0 26 27 28 0 0 0 0 0 0 6 0 0 0 37 30 30 30 36 5 0 0 7 0 0 0 0 0 0 0 0 0 0 0 0 0 0
0 0 0 0 0 0 0 0 0 10 0 0 0 0 0 0 0 0 0 0 0 0 4 11 3 0 0 0 0 0 0 0 0 0 0 0 0 0 0 0 0 0 0 0 0 5 0 0 0 0 0 0 0 0 0 0 0 0 0 0 0 0 0 0 0 0 0 30 30 30 30 30 0 0 0 6 0 0 0 0 0 0 0 0 0 0 0 0 0 0
0 0 0 0 0 0 0 0 0 9 10 0 0 0 0 0 0 0 0 0 0 0 0 0 0 0 0 0 0 0 0 0 0 0 0 0 0 0 0 0 0 0 0 0 0 0 0 0 0 0 0 0 0 0 0 0 0 0 0 0 0 0 0 0 0 0 0 30 30 30 30 30 0 0 0 0 0 0 0 0 0 0 0 0 0 0 0 0 0 0