40 30
0 0 0 0 0 0 0 0 0 0 0 0 0 0 0 0 0 0 0 0 0 0 0 0 0 0 0 0 0 0 0 0 0 0 0 0 0 0 0 0
0 0 0 0 0 0 0 0 0 0 0 0 0 0 0 0 69 67 67 67 67 67 67 67 67 67 67 68 0 0 0 0 0 0 0 0 0 0 0 0
0 0 0 0 0 0 0 0 0 0 0 0 69 67 67 67 72 62 62 62 62 62 62 62 62 62 62 73 67 67 68 0 0 0 0 0 0 0 0 0
0 0 0 0 0 0 0 0 0 0 69 67 72 62 62 62 62 62 62 62 62 62 62 62 62 62 62 62 62 62 73 67 68 0 0 0 0 0 0 0
0 0 0 0 0 0 0 0 0 69 72 62 62 62 62 62 62 62 62 62 62 62 62 62 62 62 62 62 62 62 62 62 73 68 0 0 0 0 0 0
0 0 0 0 0 0 0 0 69 72 62 62 62 62 62 62 62 62 62 62 62 62 62 62 62 62 62 62 62 62 62 62 62 73 68 0 0 0 0 0
0 0 0 0 0 0 0 0 70 62 62 62 62 62 62 62 62 62 62 62 62 62 62 62 62 62 62 62 62 62 62 62 62 62 71 0 0 0 0 0
0 0 0 0 0 0 0 69 72 62 62 62 62 62 62 62 62 62 62 62 62 62 62 62 62 62 62 62 62 62 62 62 62 62 71 0 0 0 0 0
0 0 0 0 0 0 0 70 62 62 62 62 62 62 62 62 62 62 62 62 62 62 62 62 62 62 62 62 62 62 62 62 62 62 71 0 0 0 0 0
0 0 0 0 0 0 0 70 62 62 62 62 62 62 62 62 62 62 62 62 62 62 62 62 62 62 62 62 62 62 62 62 62 62 71 0 0 0 0 0
0 0 0 0 0 0 0 70 62 62 62 62 62 62 62 62 62 62 62 62 62 62 62 62 62 62 62 62 62 62 62 62 62 62 71 0 0 0 0 0
0 0 0 0 0 0 0 70 62 62 62 62 62 62 62 62 62 62 62 62 62 62 62 62 62 62 62 62 62 62 62 62 62 62 71 0 0 0 0 0
0 0 0 0 0 0 0 70 62 62 62 62 62 62 62 62 62 62 62 62 62 62 62 62 62 62 62 62 62 62 62 62 62 62 71 0 0 0 0 0
0 0 0 0 0 0 0 70 62 62 62 62 62 62 62 62 62 62 62 62 62 62 62 62 62 62 62 62 62 62 62 62 58 53 51 0 0 0 0 0
0 0 0 0 0 0 0 70 62 62 62 62 62 62 62 62 62 62 62 62 62 62 62 62 62 62 62 62 62 62 62 62 55 60 0 0 0 0 0 0
0 0 0 0 0 0 0 70 62 62 62 62 62 62 62 62 62 62 62 62 62 62 62 62 62 62 62 62 62 62 62 58 53 51 0 0 0 0 0 0
0 0 0 0 0 0 0 52 54 62 62 62 62 62 62 62 62 62 62 62 62 62 62 62 62 62 62 62 62 62 62 53 51 0 0 0 0 0 0 0
0 0 0 0 0 0 0 0 61 62 62 62 62 62 62 62 62 62 62 62 62 62 62 62 62 62 62 62 62 62 53 51 0 0 0 0 0 0 0 0
0 0 0 0 0 0 0 0 61 59 62 62 62 62 62 62 62 62 62 62 62 62 62 62 62 62 62 62 62 62 60 0 0 0 0 0 0 0 0 0
0 0 0 0 0 0 0 0 52 54 57 57 57 59 62 62 62 62 62 62 62 62 62 62 62 62 62 62 62 62 60 0 0 0 0 0 0 0 0 0
0 0 0 0 0 0 0 0 0 52 50 50 50 54 57 57 57 59 62 62 62 62 62 62 62 62 62 62 62 62 60 0 0 0 0 0 0 0 0 0
0 0 0 0 0 0 0 0 0 0 0 0 0 52 50 50 50 54 57 59 62 62 62 62 62 62 62 62 62 62 67 67 67 68 0 0 0 0 0 0
0 0 0 0 0 0 0 0 0 0 0 0 0 0 0 0 0 52 50 54 57 59 62 62 62 62 62 62 62 62 62 62 62 73 67 67 68 0 0 0
0 0 0 0 0 0 0 0 0 0 0 0 0 0 0 0 0 0 0 52 50 54 57 59 62 62 62 62 62 62 62 62 62 62 62 62 73 67 68 0
0 0 0 0 0 0 0 0 0 0 0 0 0 0 0 0 0 0 0 0 0 52 50 54 57 59 62 62 62 62 62 62 62 62 62 62 62 62 73 67
0 0 0 0 0 0 0 0 0 0 0 0 0 0 0 0 0 0 0 0 0 0 0 52 50 54 57 59 62 62 62 62 62 62 62 62 62 62 62 62
0 0 0 0 0 0 0 0 0 0 0 0 0 0 0 0 0 0 0 0 0 0 0 0 0 52 50 54 57 59 62 62 62 62 62 62 62 62 62 62
0 0 0 0 0 0 0 0 0 0 0 0 0 0 0 0 0 0 0 0 0 0 0 0 0 0 0 52 50 54 57 59 62 62 62 62 62 62 62 62
0 0 0 0 0 0 0 0 0 0 0 0 0 0 0 0 0 0 0 0 0 0 0 0 0 0 0 0 0 52 50 54 57 57 57 59 62 62 62 62
0 0 0 0 0 0 0 0 0 0 0 0 0 0 0 0 0 0 0 0 0 0 0 0 0 0 0 0 0 0 0 52 50 50 50 54 62 62 62 62