40 30
0 0 6 0 0 0 0 0 35 31 31 31 31 31 34 0 0 0 6 0 0 0 5 0 0 37 30 30 30 30 30 36 0 0 0 0 0 0 7 0
0 0 0 0 0 7 0 7 0 35 31 31 31 34 0 0 69 67 67 67 67 67 67 67 67 48 48 48 48 30 30 30 5 0 0 7 0 0 6 0
0 10 0 0 0 6 0 6 0 0 0 47 67 67 67 67 72 95 95 95 95 95 95 95 95 30 30 30 48 48 48 30 0 0 0 6 0 0 0 0
0 8 0 0 0 0 0 0 0 0 69 29 62 62 62 62 62 91 91 91 91 91 91 91 91 30 30 30 30 30 48 48 68 0 0 0 0 0 0 0
0 37 30 30 30 36 0 0 0 69 72 29 62 62 62 62 62 91 94 91 91 91 91 94 91 75 30 30 30 30 30 74 73 67 68 37 30 30 30 36
37 30 30 30 30 30 36 0 69 72 62 29 62 62 62 62 62 91 91 91 91 91 91 91 91 62 75 30 30 30 74 62 62 62 77 48 30 30 30 30
30 30 30 30 30 30 30 0 70 62 62 29 62 62 62 84 62 91 91 91 91 91 91 91 91 62 62 62 29 62 62 62 62 62 48 30 30 30 30 30
30 30 30 30 30 30 30 69 72 62 62 29 62 62 62 62 62 91 94 91 91 91 91 94 91 62 62 62 29 62 62 62 62 62 48 30 30 30 30 30
30 30 30 30 30 30 30 70 62 62 87 29 62 62 62 62 62 91 91 91 91 91 91 91 91 62 62 84 29 62 62 62 84 62 48 30 30 30 30 30
35 30 30 30 30 30 34 70 62 62 81 82 83 62 62 62 62 91 91 91 91 91 91 91 91 62 62 62 29 62 62 62 62 62 75 48 30 30 30 30
0 35 30 30 32 34 0 70 62 62 62 62 62 62 62 62 62 91 94 91 91 91 91 94 91 62 62 62 29 62 62 62 62 62 71 35 30 30 30 34
0 0 0 25 0 0 0 70 62 62 62 62 62 62 62 62 62 91 91 91 92 93 91 91 91 62 62 62 29 62 62 62 62 62 71 0 0 25 0 0
0 0 0 25 0 0 0 70 62 62 84 62 62 62 62 62 62 98 99 91 96 97 91 101 100 62 62 62 29 62 84 62 62 62 71 0 0 25 0 0
0 0 0 25 7 0 0 70 62 62 62 62 62 62 62 62 62 62 62 62 11 11 62 62 62 62 62 62 29 62 62 62 58 53 51 0 0 25 7 0
0 0 0 25 6 7 0 70 62 62 62 77 30 30 30 76 62 62 62 62 11 11 62 62 62 62 62 81 82 83 89 62 55 60 0 0 0 25 6 0
0 0 0 25 0 6 0 70 62 62 77 30 30 30 30 30 76 62 62 62 11 11 62 62 62 62 62 62 62 62 62 58 53 51 0 0 0 25 0 0
0 0 0 25 0 0 0 52 54 62 30 30 30 30 30 30 30 62 62 62 11 11 62 62 62 62 62 62 62 62 62 53 51 0 0 7 0 25 0 0
0 5 0 25 0 0 0 0 52 54 30 30 30 30 30 30 30 62 62 62 11 11 64 62 62 62 62 62 62 62 53 51 0 0 0 6 0 25 0 0
0 0 0 25 0 0 0 0 0 52 48 48 30 30 30 30 30 62 62 62 66 11 11 64 62 62 62 62 62 62 60 0 5 0 0 0 0 25 0 0
0 0 0 25 0 0 0 0 0 0 35 48 48 30 30 30 74 62 62 62 62 66 11 11 64 62 62 62 62 62 60 0 0 5 0 0 22 23 24 0
0 0 0 25 0 8 0 0 0 5 0 35 48 48 48 74 62 62 84 62 62 62 66 11 11 64 62 62 62 62 60 0 0 0 0 0 0 0 0 0
0 0 22 23 24 10 8 0 0 0 0 0 0 25 52 50 50 54 57 59 62 62 62 66 11 11 11 64 62 62 67 67 67 68 0 0 0 9 8 0
0 0 0 0 0 0 0 0 0 0 0 0 0 25 0 0 0 52 50 54 57 59 62 62 66 11 11 11 64 62 62 89 88 73 67 67 68 0 0 0
0 0 0 7 0 0 0 0 0 0 0 0 0 25 0 0 5 0 0 52 50 54 57 59 62 62 66 11 11 11 64 62 62 62 62 62 73 67 68 0
0 0 0 6 0 0 0 0 7 0 0 0 0 25 0 0 0 0 0 0 0 52 50 54 57 59 62 66 11 11 11 11 11 64 62 62 62 86 73 67
0 0 0 0 0 0 0 0 6 0 0 0 0 25 0 0 0 0 7 0 0 7 0 52 50 54 57 59 62 66 11 11 11 11 11 64 62 85 62 62
0 0 0 0 0 0 0 0 0 0 0 0 0 25 0 0 0 0 6 0 0 6 0 0 0 52 50 54 57 59 62 62 66 11 11 11 11 64 62 62
0 0 0 10 0 0 0 0 0 0 0 0 0 25 0 9 10 0 0 0 0 0 7 0 0 0 0 52 50 54 57 59 62 62 66 11 11 11 11 64
0 0 8 10 10 0 0 0 0 5 0 0 22 23 24 0 9 0 0 0 0 0 6 0 5 0 0 0 0 52 50 54 57 57 57 59 66 11 11 11
0 0 0 0 0 0 0 0 0 0 0 0 0 0 0 0 0 0 0 0 0 0 0 0 0 0 0 0 0 0 0 52 50 50 50 54 62 62 66 11